{
    "levels": [
        [
            ["p", "e", "e", "e", "e", "e", "e", "e", "e", "e", "e", "e", "e", "e"],
            ["e", "e", "e", "e", "e", "e", "e", "e", "e", "e", "e", "e", "e", "e"],
            ["e", "e", "e", "e", "e", "e", "e", "e", "e", "e", "e", "e", "e", "e"],
            ["e", "e", "e", "e", "e", "e", "e", "e", "e", "e", "e", "e", "e", "e"],
            ["e", "e", "e", "e", "e", "e", "x", "e", "e", "e", "e", "e", "e", "e"],
            ["e", "e", "e", "e", "e", "e", "e", "e", "e", "e", "e", "e", "e", "e"],
            ["e", "e", "e", "e", "e", "e", "e", "e", "e", "e", "e", "e", "e", "e"],
            ["e", "e", "e", "e", "e", "e", "e", "e", "e", "e", "e", "e", "e", "e"],
            ["e", "e", "e", "e", "e", "e", "e", "e", "e", "e", "e", "e", "e", "e"],
            ["e", "e", "e", "e", "e", "e", "e", "e", "g", "e", "e", "e", "e", "e"]
        ],
        [
            ["p", "e", "x", "e", "e", "e", "e", "e", "e", "e", "e", "e", "e", "e"],
            ["e", "e", "e", "e", "e", "e", "e", "e", "e", "e", "e", "e", "e", "e"],
            ["e", "e", "x", "e", "x", "e", "e", "e", "e", "e", "e", "e", "e", "e"],
            ["e", "e", "e", "e", "e", "e", "e", "e", "e", "e", "e", "e", "e", "e"],
            ["e", "e", "e", "e", "e", "e", "e", "e", "e", "e", "e", "e", "e", "e"],
            ["e", "e", "e", "e", "e", "e", "e", "e", "e", "e", "e", "e", "e", "e"],
            ["e", "e", "e", "e", "e", "e", "e", "e", "e", "e", "e", "e", "e", "e"],
            ["e", "e", "e", "e", "e", "e", "g", "e", "e", "e", "e", "e", "e", "e"],
            ["e", "e", "e", "e", "e", "e", "e", "e", "e", "e", "e", "e", "e", "e"],
            ["e", "e", "e", "e", "e", "e", "e", "e", "e", "e", "e", "e", "e", "e"]
        ],
        [
            ["e", "e", "e", "e", "e", "x", "e", "e", "e", "e", "e", "e", "e", "e"],
            ["e", "e", "e", "e", "e", "e", "e", "e", "e", "e", "e", "e", "e", "e"],
            ["p", "e", "e", "e", "e", "e", "e", "e", "e", "e", "e", "e", "e", "e"],
            ["e", "e", "e", "e", "e", "x", "e", "e", "e", "e", "e", "e", "e", "e"],
            ["e", "e", "x", "e", "e", "e", "e", "e", "e", "e", "e", "e", "e", "e"],
            ["e", "e", "x", "e", "e", "e", "e", "e", "x", "e", "e", "e", "e", "e"],
            ["e", "e", "e", "e", "e", "e", "x", "e", "e", "e", "e", "e", "e", "e"],
            ["e", "e", "x", "e", "e", "e", "e", "e", "e", "e", "e", "e", "e", "e"],
            ["e", "e", "e", "e", "e", "e", "e", "e", "e", "e", "e", "e", "e", "e"],
            ["e", "e", "e", "g", "e", "e", "e", "e", "x", "e", "e", "e", "e", "e"]
        ]
    ]
}