{
    "levels": [
        [
            ["p", "e", "e", "e", "e", "e", "e", "e", "e", "x"],
            ["e", "e", "e", "e", "e", "e", "e", "e", "e", "e"],
            ["e", "e", "e", "e", "e", "e", "e", "e", "e", "e"],
            ["e", "e", "e", "e", "x", "e", "e", "e", "e", "e"],
            ["e", "e", "e", "e", "e", "e", "x", "e", "e", "e"],
            ["e", "e", "e", "e", "e", "e", "e", "x", "e", "e"],
            ["e", "e", "e", "e", "e", "x", "e", "e", "e", "e"],
            ["e", "e", "e", "e", "e", "e", "e", "x", "e", "e"],
            ["e", "e", "e", "e", "e", "e", "e", "e", "e", "e"],
            ["e", "e", "e", "e", "e", "e", "e", "e", "e", "e"]
        ],
        [
            ["p", "e", "x", "e", "e", "e", "x", "e", "e", "e"],
            ["e", "e", "x", "e", "e", "e", "x", "e", "e", "e"],
            ["e", "e", "x", "x", "x", "e", "x", "e", "e", "e"],
            ["e", "e", "e", "e", "e", "e", "x", "e", "e", "e"],
            ["e", "e", "e", "e", "e", "e", "x", "e", "e", "e"],
            ["e", "e", "e", "e", "e", "e", "x", "e", "e", "e"],
            ["e", "e", "e", "e", "x", "e", "x", "e", "x", "e"],
            ["e", "e", "e", "e", "x", "e", "e", "e", "x", "e"],
            ["e", "e", "e", "e", "e", "e", "e", "e", "x", "e"],
            ["e", "e", "e", "e", "e", "e", "e", "e", "x", "e"]
        ],
        [
            ["e", "e", "e", "e", "e", "x", "e", "e", "e", "e"],
            ["e", "e", "e", "e", "e", "x", "e", "e", "e", "e"],
            ["p", "e", "e", "e", "e", "x", "e", "e", "e", "e"],
            ["e", "e", "e", "e", "e", "x", "e", "e", "e", "e"],
            ["e", "e", "x", "e", "e", "x", "x", "e", "e", "e"],
            ["e", "e", "x", "e", "e", "e", "x", "e", "x", "e"],
            ["e", "e", "x", "e", "e", "e", "x", "e", "x", "e"],
            ["e", "e", "x", "e", "e", "e", "e", "e", "x", "e"],
            ["e", "e", "x", "e", "e", "e", "e", "e", "x", "e"],
            ["e", "e", "x", "e", "e", "e", "e", "e", "x", "e"]
        ]
    ]
}